NO assets/mossy.xpm
SO assets/greystone.xpm
EA assets/eagle.xpm
WE assets/redbrick.xpm

F 192,192,192
C 64,64,64

111111111111111111111111111111
100000000000000N00000000000001
100000000000000000000000000001
100000000000000000000000000001
100000000000000000000000000001
100000000000000000000000000001
100000000000000000000000000001
100000000000000000000000000001
100000000000000000000000000001
100000000000000000000000000001
100000000000000000000000000001
100000000000000000000000000001
111111111111111111111111111111
