NO assets/mossy.xpm
SO assets/greystone.xpm
EA assets/eagle.xpm
WE assets/redbrick.xpm

F 192,192,192
C 64,64,64

000000001111111111111111111111110
000000001000000000110000000000001
0000000010110000011100000S0000001
000000001001000000000000000000001
111111110011000001110000000000001
100000000011000001110111111111111
11110111111111011100000010001
11110111111111011101010010001
11000000110101011100000010001
10000000000000001100000010001
10000000000000001101010010001
1100000111010101111101111000111
11110111 1110101 101111010001
11111111 1111111 111111111111
