NO assets/mossy.xpm
SO assets/mossy.xpm
EA assets/mossy.xpm
WE assets/mossy.xpm

F 192,192,192
C 64,64,64

111111111111111111111111111111
100000000000000000000000000001
100000000000000000000000000001
100000000000000000000000000001
100000000000000000000000000001
100000000000000000000000000001
100000000000000W00000000000001
100000000000000000000000000001
100000000000000000000000000001
100000000000000000000000000001
100000000000000000000000000001
100000000000000000000000000001
111111111111111111111111111111
