 100
NO ./textures/greystone.xpm
SO ./textures/redbrick.xpm
EA ./textures/wood.xpm
WE ./textures/wood.xpm

C 255,200,160
F 122,122,122

11111111111111111
10000000000000001
10000000000000001
10000000000000001
10000000000000001
10000000000000001
10000000N00000001
10000000000000001
10000000000000001
10000000000000001
10000000000000001
10000000000000001
11111111111111111
