
NO ../../assets/greystone.xpm
SO ../../assets/redbrick.xpm
EA ../../assets/wood.xpm
WE ../../assets/wood.xpm

C 255,200,160
F 122,122,122

21111111111111111
10000000000000001
10000000000000001
10000000000000001
10000000000000001
10000000000000001
10000000N00000001
10000000000000001
10000000000000001
10000000000000001
10000000000000001
10000000000000001
11111111111111112
