
NO assets/greystone.xpm
SO assets/redbrick.xpm
EA assets/wood.xpm
WE assets/wood.xpm

C 255,200,160
F 122,122,122

11111111111111111
10000000000000001
10000000000000001
10000000000000001
10000000000000001
10000000000000001
10000000000000001
10000000000000001
10000000000000001
10000000000000001
10000000000000001
10000000000000001
1111111111111111N
